11111111
1P000001
1000C0E1
100001C1
11111111