11111111111111111
10000000100000C11
10000C00000P00001
1E000001000100001
11111111111111111