11111
100E1
10001
1CP01
10001
10C01
11111