11111111111
10000E0001
10P0000C0001
11111111111